0100101101
0110111100
0011111011
1001101111
1111001100
0111000001
0100111010
1100100111
0010000111
1010000101
